F 76,7 6,76
C 99,99,257

NO ./textures/wolftex/bluestone.xpm
SO ./textures/wolftex/eagle.xpm
WE ./textures/wolftex/mossy.xpm
EA .//textures/wolftex/purplestone.xpm

1111111111111111111
1000000000000000001
1011110111110111101
1000010000010000101
1000010000010000101
10000100S0010000101
1011110111110111101
1000000000000000001
1111111111111111111
